1,1,1,1,4,4,1,1,1,1
1,0,0,1,0,0,0,0,8,1
1,0,0,1,1,1,1,5,0,1
4,0,0,0,6,0,1,0,0,4
4,0,0,0,0,0,1,0,0,4
1,1,7,1,0,0,1,5,0,1
1,4,0,0,0,0,0,0,8,1
1,1,1,1,4,4,1,1,1,1