1,1,1,1,0,0,1,1,1,1
1,0,0,5,0,0,0,0,0,1
1,7,7,1,0,0,0,5,0,1
0,7,7,7,0,0,5,0,0,1
0,7,7,7,0,5,0,0,0,1
1,0,7,0,5,0,1,5,0,1
1,6,0,5,0,0,1,0,6,1
1,1,1,1,0,0,1,1,1,1