1,1,0,0,0,0,0,5,0,0
1,1,4,1,0,0,4,0,1,0
0,5,0,0,0,0,0,0,1,0
0,1,6,0,5,0,4,0,0,0
0,1,7,1,1,1,0,1,0,0
4,0,1,1,0,1,0,0,5,0
0,0,0,4,0,0,0,4,0,0
0,5,7,6,7,6,1,1,1,0